8
amenity=school
29
1298403715
1173487109
1193124746
1194804874
1187119114
1321544594
1173486765
1193218606
1149055284
1321544508
1187088701
1159931587
1321544133
1160057031
1103651789
1173452880
1299524308
1174124502
1183630423
1180139995
1298799452
1187086175
1178253281
1174117218
1174116581
1316588135
1298415724
1167369717
1191478781
building=school
29
1183684097
1321544194
1174116867
278486921
1166043413
1173425045
1194804887
1321544219
1197705247
1188236839
1187136563
1194803507
1183684149
1191507768
1173444024
1173486524
1191453629
1183621570
1193320915
1159931477
1321544410
1158156518
1174116585
1183684206
1188391406
1187086319
1191393779
1167369717
1192542591
amenity=driving_school
29
1173486851
278486916
449815818
1187121677
1113220497
1187121682
1318752273
1149049233
1158156561
1173440050
1173452723
1187130555
1173444027
449815867
1187130562
1173486658
1159931333
1173487052
1159931471
1180139990
1149039190
1173497313
445088876
1187136624
278486899
1186466931
1214152702
1160107516
1187136638
school=*
29
1174116482
1187121682
875811225
1308679582
1174116896
1174116648
1188236844
1174116908
445099442
1173486774
1183684152
1194803513
1173487036
1149057852
1187136580
1113220425
1104540617
1214153675
278486603
1149052113
1180139988
1308678999
1299524316
1188391390
1173440095
1183721322
1158156522
1191393779
278486901
amenity=music_school
29
1174116487
1185825673
449815818
1174116875
1159958285
1174116753
1182447896
1187130533
1160057004
1149052086
1193130423
1178253243
1191393854
1191408706
1183641795
1173486663
1103651784
1104540617
1173487052
449815887
1174120911
1298799449
1174124508
1173452774
1173424999
449815789
1159931373
1191478775
1173452925
amenity=language_school
29
1187086209
1321544195
1174124550
449815815
1173424923
1158156577
1191411619
1113220264
1174124587
1173487022
449815855
1188232499
1321544500
1113220277
1183630387
1321544380
1187130563
1183623238
1191393737
1161008074
1159931482
449815772
1187130589
1178253280
1321544166
1187136616
1155459178
1173487091
269567733
amenity=dancing_school
29
1185825667
1298403718
1183684104
1186511121
1187121690
1166043420
1174124577
1186511143
1187086122
1173440045
1183630392
1187130554
1158156474
1183652031
1193130432
1188232515
1173444037
1159931471
1166043477
1179851736
1149024602
449815900
1173452901
1113220461
1187136626
1190255731
1173452792
1193218555
278486909
amenity=ski_school
29
1193617152
1321544196
1186511109
1183630470
1321544197
1183641865
1187121679
1194804882
1158156572
1183683996
1155459230
1174117150
1173487010
1173457698
1173425061
1194804906
1321544619
278974126
1113220272
1321544375
1160057027
1113220423
1321544651
1173425101
1299524322
1321544164
1187136619
1160107513
1174116479