6
vending=parcel_mail_in
29
1174116994
1183641861
1185825670
1191453582
1183684240
1190255765
1321544217
1173440028
1193624354
1183652013
1187130549
1187087927
1174117051
1183652034
1160057031
1189056711
1321544530
1174116692
1160057046
1155459162
1299524315
1149039198
1173452896
1174117218
1173444067
1186466930
1191453561
1187136637
1183630462
amenity=post_box
29
1186511107
1158156421
1194804875
1113220497
1173425051
1161008035
1158156455
278730280
1173452843
1155459245
1173452720
1187136562
1160057011
1183621568
1113220419
1308680643
1173444037
1194803525
1187086281
1178253260
1188232528
1173486944
1173486689
1158156527
1188185969
1155459316
1193302905
1174116604
1192542591
amenity=post_office
29
1173452931
449815946
1161020683
1173486739
1321544470
1194804891
1183684000
1186469882
1194803365
1187130538
1187130545
1187130548
1173486900
1183708724
1321544249
1193130427
1178253253
1173440074
1179847757
1321544278
1149024601
1174117210
1174120926
1299524327
1174116978
1173486838
269567736
1173452794
445088893
post_box:type=*
29
1165960706
1159931396
1298403716
449815953
1149049236
1321544342
26122777
1159958298
278730283
278730288
1160057011
1193302843
1174116545
1173486915
1173424969
1103651659
1183621584
1159066065
1190301010
1173494099
449822805
1158156502
449822812
1321544289
1173425005
1187136631
1173425017
1113220349
278486911
post_office=*
29
1183701890
1183701891
1183684103
1174116753
1194804887
1214153113
1194804890
1187119132
1173444006
1167369769
1174116908
1183630387
1173486524
1158156481
1188232516
1167373126
1318750790
1308678988
1173452876
1316588131
1173487087
445088881
1173452786
1190255731
1191393781
1187136633
1160107515
1188185981
1103651839
amenity=post_depot
29
1113220354
1192542600
1159931529
1321544591
1173486863
1188391444
1155459352
1186511137
1159071653
1113220479
1191397552
1191393716
269567672
1185825984
1188232515
1174116931
1166043468
1188198864
1321544282
1187130586
1174120926
1174117214
1174116712
1173486571
1183641842
1174120948
1188241525
1160107515
1166036863